丽	gmmg #↓兼容汉字扩展U+2F800-2FA1D 93646-94187行 共542字
丸	rwuj
乁	bu
𠄢	emde
你	tpcx
侮	tpce
侻	txov
倂	tppe
偺	tvlk
備	thgs
僧	txkk
像	tqtr
㒞	tatm
𠘺	yave
免	dovd
兔	dowd
兤	ngkt
具	ngtu
𠔜	uotu
㒹	vnti
內	muu
再	emu
𠕋	meme
冗	qve
冤	qdvw
仌	uuu
冬	vxs
况	eove
𩇟	xens
凵	au
刃	dwud
㓟	dldp
刻	yldh
剆	wbld
割	weol
剷	ypll
㔕	pclq
勇	dkcl
勉	qovc
勤	hoec
勺	sgu
包	sdj
匆	sswu
北	xvi
卉	ehv
卑	ujpe
博	eewi
即	blae
卽	uvab
卿	vpva
卿	vpaa
卿	vpva
𠨬	rvi
灰	gxvc
及	awun
叟	kdos
𠭣	brdo
叫	oau
叱	ovi
吆	opai
咞	oghv
吸	oawu
呈	oev
周	sfov
咢	oecx
哶	ohfu
唐	wbog
啓	zpoh
啣	opae
善	xxoy
善	xjho
喙	obru
喫	oedf
喳	oinq
嗂	ovpf
圖	naow
嘆	ohoj
圗	naew
噑	ouee
噴	oehn
切	jdd
壮	xjv
城	jfed
埴	jvnc
堍	jdvw
型	eejg
堲	uvjb
報	jxdd
墬	bbrj
𡓤	juun
売	jqqj
壷	jqen
夆	vif
多	qqxx
夢	hmqq
奢	fjkd
𡚨	cvi
𡛪	chcs
姬	cfdk
娛	cocf
娧	cxov
姘	cppe
婦	cbqm
㛮	cwud
㛼	crkv
嬈	crkv
嬾	ciqn
嬾	ciog
𡧈	wgjk
寃	wdvw
寘	wvct
寧	wrme
寳	wecn
𡬘	cuny
寿	iicf
将	xsic
当	cbux
尢	hcu
㞁	hckv
屠	djwk
屮	au
峀	mko
岍	meeg
𡷤	mocf
嵃	myps
𡷦	uvmb
嵮	mvct
嵫	mhaa
嵼	mypp
巡	czdc
巢	cuic
㠯	ddu
巽	ddts
帨	mxvj
帽	mknj
幩	menj
㡢	mmyj
𢆃	mhvj
㡼	wkpg
庰	wpeg
庳	wkeg
庶	whsg
廊	wwbg
𪎒	wqam
廾	hv
𢌱	gcgh
𢌱	gcgh
舁	uhvj
弢	dmdg
弢	dadg
㣇	bsmj
𣊸	sspm
𦇚	cgea
形	eesg
彫	sfos
㣣	sfvr
徚	sikr
忍	dwrd
志	frx
忹	uev
悁	uasv
㤺	uycv
㤜	ufgu
悔	upce
𢛔	uinx
惇	uweb
慈	haar
慌	uhcv
慎	uent
慌	uhav
慺	ukoc
憎	uxkk
憲	wemr
憤	uehn
憯	ufvk
懞	ulgg
懲	smrr
懶	uiog
成	fedw
戛	gnfg
扝	fecu
抱	fsdj
拔	fhdw
捐	fasv
𢬌	frdw
挽	fdov
拼	fppe
捨	fujo
掃	fbqm
揤	fuva
𢯱	fwxd
搢	fhxk
揅	geer
掩	ffuc
㨮	fvdq
摩	wrsm
摾	fdol
撝	fvsu
摷	fcui
㩬	flxf
敏	pcep
敬	hsop
𣀊	yppl
旣	uvvb
書	bjkv
晉	eake
㬙	kxw
暑	kjwk
㬈	knum
㫤	kzo
冒	knv
冕	kqov
最	khdo
暜	yykl
肭	smvr
䏙	sqve
朗	wbsv
望	ycse
朡	stvv
杞	idi
杓	isgu
𣏃	ibu
㭉	hiv
柺	iocl
枅	ieeg
桒	ehiv
梅	ipce
𣑭	isse
梎	iuvi
栟	ippe
椔	icgk
㮝	itoa
楂	iinq
榣	ivpf
槪	iufv
檨	ixeq
𣚣	ikgt
櫛	ipva
㰘	ibah
次	xqqs
𣢧	uuqj
歔	llqh
㱎	maqw
歲	lffz
殟	gkmd
殺	teqi
殻	jqqq
𣪍	dgqq
𡴋	acm
𣫺	pcas
汎	zqa
𣲼	zqrj
沿	zqov
泍	zigu
汧	zeeg
洖	zocf
派	zrrt
海	zpce
流	zyav
浩	zpov
浸	zbqd
涅	zkig
𣴞	ztdj
洴	zppe
港	zhtd
湮	zejv
㴳	zjjs
滋	zhaa
滇	zvct
𣻑	ztvq
淹	zfuc
潮	zesz
𣽞	zklo
𣾎	zjgs
濆	zehn
瀹	zumm
瀞	zebb
瀛	zybf
㶖	ztvm
灊	zfxk
災	cgxc
灷	xhv
炭	mhxv
𠔥	xbls
煅	xdeq
𤉣	xcgk
熜	xuvr
𤎫	xxtu
爨	umfx
爵	vmli
牐	trkp
𤘈	fuuy
犀	dapn
犕	phsn
𤜵	veeq
𤠔	vanq
獺	vigq
王	ev
㺬	eqa
玥	esv
㺸	tbte
㺸	tbew
瑇	eech
瑜	eusc
瑱	evct
璅	ecui
瓊	eqnv
㼛	eehg
甤	gpss
𤰶	kks
甾	cgkc
𤲒	kxht
異	khtt
𢆟	kpeo
瘐	wkwb
𤾡	uxwb
𤾸	uhsb
𥁄	gjmm
㿼	eemg
䀈	uvmb
直	encu
𥃳	ngjk
𥃲	nhv
𥄙	njtu
𥄳	masw
眞	vkti
真	engt
真	enct
睊	nasv
䀹	nfuu
瞋	nvct
䁆	nfuc
䂖	gwov
𥐝	gsgu
硎	geel
碌	gbas
磌	gect
䃣	gvsu
𥘦	wpps
祖	jtnq
𥚚	wlvs
𥛅	wvks
福	whks
秫	riwu
䄯	reeg
穀	jqrq
穊	rufv
穏	rvbr
𥥼	wvmh
𥪧	yvtl
𥪧	yetl
竮	ydel
䈂	pppe
𥮫	pmxm
篆	pbru
築	piqi
䈧	pvsu
𥲀	pcui
糒	xhsm
䊠	uvxb
糨	xdlm
糣	xfck
紀	adi
𥾆	accu
絣	appe
䌁	aecv
緇	acgk
縂	ator
繅	acui
䌴	aybf
𦈨	peef
𦉇	pdef
䍙	mpcw
𦋙	mtuc
罺	mciw
𦌾	marw
羕	xjya
翺	ticz
者	jwkv
𦓚	rgmg
𦔣	ifhl
聠	hpee
𦖨	imlh
聰	hure
𣍟	qgsv
䏕	sev
育	yasv
脃	sqdb
䐋	star
脾	skpe
媵	sxjc
𦞧	svdk
𦞵	suig
𣎓	sybl
𣎜	som
舁	uhv
舄	ucsj
辞	eoyg
䑫	rpeo
芑	hdi
芋	hgiu
芝	hzz
劳	hqcl
花	htvi
芳	aayu
芽	hfy
苦	hjg
𦬼	hpcx
若	hhov
茝	hfdk
荣	hqiv
莭	hbaa
茣	hoft
莽	hfhv
菧	hwvf
著	hjkv
荓	hppe
菊	hsxm
菌	hnrv
菜	hviv
𦰶	hjso
𦵫	hjqa
𦳕	hkhv
䔫	hbim
蓱	hzpe
蓳	hhoe
蔖	hlkg
𧏊	hllv
蕤	hgps
𦼬	hznm
䕝	hrmj
䕡	hnoo
𦾱	hfui
𧃒	haoc
䕫	hltv
虐	lfgh
虜	lkch
虧	ltch
虩	cpvx
蚩	aglv
蚈	leeg
蜎	lasv
蛢	lppe
蝹	lkmm
蜨	llbl
蝫	ljwk
螆	lxaa
䗗	lpee
蟡	lrsu
蠁	cpbl
䗹	lhar
衠	svtx
衣	yttu
𧙧	wghi
裗	wyvi
裞	wxvi
䘵	wbai
裺	wfci
㒻	knj
𧢮	gmwn
𧥦	ygjk
䚾	yev
䛇	yqov
誠	yfju
諭	yusc
變	yaav
豕	gs
𧲨	veez
貫	cnbm
賁	ehnb
贛	yknl
起	jdjz
𧼯	jucz
𠠄	jnlz
跋	ohwz
趼	oeez
跰	opez
𠣞	sjc
軔	jdwc
輸	jucc
𨗒	jrzy
𨗭	ukjz
邔	dbvi
郱	peeb
鄑	hxbj
𨜮	vplb
鄛	cubc
鈸	vhdw
鋗	vasv
鋘	vocf
鉼	vppe
鏹	vdol
鐕	vfvk
𨯺	vugx
開	neem
䦕	npem
閷	tiui
𨵷	nnmm
䧦	bxw
雃	eetg
嶲	atmu
霣	jany
𩅅	jzhy
𩈚	gnpe
䩮	hbag
䩶	halg
韠	dkfw
𩐊	ymlg
䪲	ggyw
𩒖	ghgy
頋	gbgc
頋	gdgc
頩	peeg
𩖶	qiwf
飢	vves
䬳	vtfs
餩	vuys
馧	rkkm
駂	veei
駾	exvm
䯎	nueg
𩬰	eiqb
鬒	eetb
鱀	uvqb
鳽	eeug
䳎	uun
䳭	baau
鵧	peeu
𪃎	ugcu
䳸	wunm
𪄅	teui
𪈎	iogu
𪊑	weel
麻	wevg
䵖	fkaf
黹	agmt
黾	okd
鼅	pooi
鼏	qnat
鼖	ehed
鼻	tkhz
𪘀	lpec
