豈	mgox #↓兼容汉字U+F900-FAD9 93174-93645行 共472字
更	gkti
車	jc
賈	enbx
滑	zng
串	ooku
句	sov
龜	qom
龜	qom
契	idff
金	vv
喇	oiol
奈	ffsd
懶	uidn
癩	winb
羅	matw
蘿	hmat
螺	lkav
裸	wkii
邏	mazw
樂	uaib
洛	zvov
烙	xvov
珞	evov
落	hzvo
酪	evoy
駱	evom
亂	vddc
卵	vxaw
欄	innx
爛	xnnx
蘭	hnnx
鸞	yaau
嵐	mqf
濫	zfgm
藍	hfgm
襤	wfmi
拉	fyl
臘	sczc
蠟	lczc
廊	wwbg
朗	wbas
浪	zwbg
狼	vwbq
郎	wbbv
來	iuuu
冷	xuas
勞	xxqc
擄	flkc
櫓	iqkv
爐	xlkm
盧	lkmh
老	jvi
蘆	hlkm
虜	lkch
路	ovoz
露	jooy
魯	qkv
鷺	ovuz
碌	gcga
祿	fcas
綠	acga
菉	hcga
錄	vcga
鹿	wl
論	yugm
壟	ysjl
弄	ehv
籠	pysl
聾	yshl
牢	wpn
磊	gggv
賂	nvob
雷	jkty
壘	kkjt
屢	dooc
樓	iooc
淚	zrjq
漏	zdjy
累	kavt
縷	aooc
陋	bguc
勒	hclg
肋	scl
凜	xyrs
凌	xjvs
稜	rjvv
綾	ajvv
菱	hjvv
陵	bjvv
讀	yjvn
拏	cdrs
樂	uaib
諾	yhho
丹	syu
寧	wrme
怒	cdrx
率	yaxe
異	khtt
北	xvi
磻	gpxk
便	tgkt
復	spvr
不	gb
泌	zrpu
數	oecp
索	eqav
參	aasi
塞	whtj
省	cpnx
葉	hhiv
說	ytov
殺	tiqi
辰	gn
沈	zqve
拾	fugo
若	hhov
掠	fyoc
略	kvot
亮	yoqv
兩	gmvv
凉	xycs
梁	zdti
糧	xkem
良	wbg
諒	yyoc
量	kgke
勵	ghcc
呂	ouu
女	cv
廬	wlmg
旅	ypru
濾	zlkr
礪	gghk
閭	noum
驪	egwm
麗	gmkw
黎	rsua
力	cl
曆	grkc
歷	grlc
轢	juic
年	pfu
憐	uxqf
戀	yaar
撚	fsjs
漣	zjzd
煉	xinx
璉	ejzd
秊	rrq
練	ainx
聯	haae
輦	jjjf
蓮	hjzd
連	jzdc
鍊	vinx
列	gldd
劣	cpcx
咽	onfd
烈	glsd
裂	glwd
說	ytov
廉	wstg
念	ugbr
捻	fubr
殮	guqd
簾	pwlt
獵	vccq
令	ugae
囹	nuaw
寧	wrme
嶺	muag
怜	uuga
玲	euga
瑩	xxew
羚	xuay
聆	huae
鈴	vuga
零	juay
靈	jouy
領	ugag
例	tgld
禮	fmxs
醴	emxy
隸	jfba
惡	enre
了	bl
僚	tfkc
寮	wfkc
尿	das
料	xzem
樂	uaib
燎	xfkc
療	wfcb
蓼	hcus
遼	fxzd
龍	ysll
暈	kqjc
阮	bggw
劉	vwvl
杻	idee
柳	ivpa
流	zyav
溜	zvdk
琉	eyav
留	vwdk
硫	gyav
紐	adee
類	xjgm
六	ytu
戮	cufy
陸	bjvj
倫	tugm
崙	mugm
淪	zugm
輪	jumc
律	sbfr
慄	ueiv
栗	eiv
率	yaxe
隆	bvgp
利	rld
吏	goti
履	dskv
易	kssu
李	ibz
梨	rliv
泥	zdvi
理	ekee
痢	wrlb
罹	mutw
裏	wkey
裡	wkei
里	keej
離	ytat
匿	fhof
溺	zdds
吝	yovw
燐	xxqf
璘	exqf
藺	hntw
隣	bxqf
鱗	qxqf
麟	wxfl
林	iiv
淋	ziiv
臨	fpoe
立	yl
笠	pyl
粒	xylm
狀	ajqp
炙	sxv
識	yyfg
什	teu
茶	huiv
刺	imld
切	fddq
度	whdg
拓	fgv
糖	xwom
宅	wpfq
洞	zmgo
暴	khta
輻	jgkc
行	sx
降	bvfu
見	nj
廓	wybg
兀	gw
嗀	jqoq
﨎	ytdw
﨏	jtuo
塚	jqgw
﨑	myob
晴	kemo
﨓	ihti
﨔	iztr
凞	xfss
猪	vjkq
益	tgtm
礼	fcus
神	fkss
祥	fxys
福	fgks
靖	yeol
精	xeom
羽	cy
﨟	hsuc
蘒	hrpo
﨡	lps
諸	yjwk
﨣	jzez
﨤	awzn
逸	qowz
都	jwkb
﨧	vjbz
﨨	vjxe
﨩	bumv
飯	vgds
飼	vbos
館	vwds
鶴	wtun
郞	wbbv
隷	jfba
侮	tpcm
僧	ttxk
免	dovd
勉	qovc
勤	hecg
卑	upeb
喝	okuc
嘆	ohoj
器	ojox
塀	jdxh
墨	mjvh
層	dtxk
屮	au
悔	upcm
慨	uufv
憎	utxk
懲	smrr
敏	pcpp
既	ulvb
暑	kjwk
梅	ipcm
海	zpcm
渚	zjwk
漢	zhoj
煮	jwks
爫	vu
琢	egwu
碑	gupe
社	fjvs
祉	flzs
祈	frjs
祐	fhos
祖	fnqs
祝	fovs
禍	fnos
禎	flns
穀	jqrq
突	wvjq
節	pula
練	ainx
縉	ahxk
繁	pcpa
署	mjkw
者	jwkv
臭	tjqz
艹	hv
艹	hv
著	hjwk
褐	wkci
視	fnjs
謁	ykuc
謹	yhee
賓	wgnn
贈	ntkb
辶	zd
逸	qowz
難	hgjt
響	cpby
頻	lcgz
恵	gkwr
𤋮	fdse
舘	ujdd
並	xagu
况	eove
全	uev
侀	trel
充	yave
冀	xvht
勇	dscl
勺	swu
喝	oksv
啕	osgl
喙	obru
嗢	okmm
塚	jqgs
墳	jehn
奄	fkdd
奔	fehd
婢	ckeu
嬨	cyar
廒	wepg
廙	wktg
彩	pxss
徭	srar
惘	umvc
慎	uent
愈	vgrr
憎	uxxk
慠	ueqp
懲	smrr
戴	efht
揄	fvsl
搜	fukd
摒	fdyh
敖	eqpp
晴	kesv
朗	wbas
望	ycse
杖	ihww
歹	gd
殺	tiqi
流	zyav
滛	zrpf
滋	zyya
漢	zhoj
瀞	zebb
煮	jksh
瞧	ntsh
爵	rmiz
犯	vdsq
猪	vjkq
瑱	eect
甆	yaah
画	gkau
瘝	wmab
瘟	wkmb
益	xtmm
盛	femw
直	enq
睊	nasv
着	xnvy
磌	gent
窱	wvvi
節	pbaa
类	xjqm
絛	tkva
練	aikv
缾	psef
者	yvsl
荒	hvcv
華	hehu
蝹	lnum
襁	wdli
覆	gmkv
視	wnjs
調	ysjo
諸	yjkv
請	yesv
謁	yksv
諾	yhho
諭	yvsl
謹	yhoj
變	yaav
贈	ntkb
輸	jvlc
遲	dafz
醙	eudy
鉶	veel
陼	bjkv
難	hojt
靖	yesl
韛	dhsw
響	cpby
頋	gdgc
頻	lcgz
鬒	eetb
龜	pom
𢡊	urrr
𢡄	urrk
𣏕	ievw
㮝	itob
䀘	neeg
䀹	nfvv
𥉉	ntvi
𥳐	pnre
𧻓	jpez
齃	tkvb
龎	gykc
