可	a
又	b
也	c
不	d
的	e
一	f
大	g
都	h
所	i
是	j
上	k
中	l
当	m
些	n
为	o
这	p
我	q
和	r
而	s
人	t
着	u
了	v
生	w
以	x
心	y
把	ac
七	aq
她	cc
好	cv
要	dc
越	dg
百	dj
真	dm
还	dp
十	du
期	dw
他	ec
但	ej
们	ep
你	ey
五	fc
天	fg
束	fl
想	fm
来	fp
死	fr
三	fs
太	go
地	hc
干	hg
示	hu
去	hv
没	iq
学	iy
时	ja
昨	jq
日	jr
明	jw
早	jz
里	kl
遇	kp
呢	lb
吧	lc
非	lf
口	lk
只	lt
哪	lv
吗	lx
四	nq
就	om
它	or
六	ot
说	ou
年	qa
每	qb
等	qh
几	qj
得	rj
很	rv
二	se
与	sf
在	sn
有	sw
八	tb
个	tn
今	to
站	um
并	us
那	va
能	vw
月	wy
九	yj
