想	a
比	b
让	c
的	d
这	e
来	f
和	g
都	h
为	i
是	j
中	k
了	l
着	m
不	n
那	o
先	p
内	q
及	r
被	s
以	t
个	u
即	v
我	w
在	x
多	y
动	ak
图	bk
话	ck
能	dk
但	ek
打	fk
等	gk
表	ha
学	ia
出	ja
呢	ka
前	la
分	ma
还	na
将	oa
靠	pa
刚	qk
问	rk
与	sk
数	tk
从	ua
好	wk
有	xk
然	ya
快	bo
许	co
就	do
拿	so
点	uo
新	wo
关	ld
没	nd
送	lf
