需要	sn
什么	en
包括	iv
时候	je
重要	jl
努力	ws
需求	sf
感觉	ki
数据	tf
必须	nw
函数	ot
科学	gi
技术	fa
科技	gf
免费	oj
付费	ej
登录	dv
大学生	mip
计算机	cga
互联网	flq
消费者	njh
办公室	smi
是不是	jnj
有没有	xnx
一个人	fuu
越来越	hfh
自定义	cii
委员会	gku
%	vw
·	vj
——	vp
‘	zb
’	vb
“	zn
”	vn
……	vl
、	va
《	zo
》	vo
「	zy
」	vy
『	zu
』	vu
！	zt
，	zd
。	zj
？	zw
；	zf
：	zm
（	zk
）	vk
～	ve
【	zr
】	vr
0	zno
1	zny
2	zne
3	zns
4	zni
5	znw
6	znl
7	znq
8	znb
9	znj
A	zva
B	zvb
C	zvc
D	zvd
E	zve
F	zvf
G	zvg
H	zvh
I	zvi
J	zvj
K	zvk
L	zvl
M	zvm
N	zvn
O	zvo
P	zvp
Q	zvq
R	zvr
S	zvs
T	zvt
U	zvu
V	zvv
W	zvw
X	zvx
Y	zvy
Z	zvz
a	zma
b	zmb
c	zmc
d	zmd
e	zme
f	zmf
g	zmg
h	zmh
i	zmi
j	zmj
k	zmk
l	zml
m	zmm
n	zmn
o	zmo
p	zmp
q	zmq
r	zmr
s	zms
t	zmt
u	zmu
v	zmv
w	zmw
x	zmx
y	zmy
z	zmz
